17 18
825 750
0 0 0 0 0 0 0 0 0 0 0 0 0 0 0 0 0
0 0 0 0 0 0 0 0 0 0 0 0 0 0 0 0 0
0 0 0 0 0 0 0 0 0 0 0 0 0 0 0 0 0
0 0 0 0 0 0 0 0 0 0 0 0 0 0 0 0 0
0 0 0 0 0 0 0 0 0 0 0 0 0 0 0 0 0
0 0 0 0 0 16 16 16 16 16 16 14 15 15 0 0 0
0 0 0 0 0 16 16 16 16 16 16 16 16 15 0 0 0
0 0 0 0 0 16 16 16 16 16 16 16 16 16 0 0 0
0 0 0 0 0 16 16 16 16 16 16 16 16 16 0 0 0
0 0 0 0 0 16 16 16 16 16 16 16 16 16 0 0 0
0 0 0 0 0 16 16 16 16 16 16 16 16 0 0 0 0
0 0 0 0 0 16 16 16 16 16 16 16 16 16 15 0 0
0 0 0 0 0 16 16 16 16 16 16 16 16 15 0 0 0
0 0 0 0 0 16 16 16 16 16 16 16 14 0 0 0 0
0 0 0 0 0 16 14 16 16 16 16 16 0 0 0 0 0
0 0 0 0 0 0 0 0 0 0 0 0 0 0 0 0 0
0 0 0 0 0 0 0 0 0 0 0 0 0 0 0 0 0
0 0 0 0 0 0 0 0 0 0 0 0 0 0 0 0 0

