14 10 
260 390
0 0 0 0 0 0 0 0 0 0 0 0 0 0  
0 0 0 0 0 0 0 0 0 0 0 0 0 0  
0 0 0 0 0 0 0 0 0 0 0 0 0 0  
0 0 0 0 3 3 3 3 3 3 3 0 0 0  
0 0 0 0 17 17 17 17 17 17 18 3 0 0
0 0 0 0 17 17 3 3 3 3 17  3 0 0
0 0 0 0 17 17 17 17 17 17 17 3 0 0
0 0 0 0 17 0 0 0 0 0 0 0 0 0  
0 0 0 0 0 0 0 0 0 0 0 0 0 0  
0 0 0 0 0 0 0 0 0 0 0 0 0 0  
