17 14
330 580
0 0 0 0 0 0 0 0 0 0 0 0 0 0 0 0 0
0 0 0 0 0 0 0 0 0 0 0 0 0 0 0 0 0
0 0 0 0 0 0 0 0 0 0 0 0 0 0 0 0 0
0 0 0 0 0 0 4 0 0 0 0 0 0 0 0 0 0
0 0 0 0 7 7 7 7 7 7 7 7 0 0 0 0 0
0 0 0 0 7 7 7 7 7 6 6 7 7 0 0 0 0
0 0 0 0 7 7 7 7 6 6 6 6 6 6 0 0 0
0 0 0 9 7 7 7 7 6 6 6 6 6 6 0 0 0
0 0 0 7 7 7 7 7 6 6 6 6 6 6 0 0 0
0 0 4 7 7 7 7 7 6 6 6 6 6 6 0 0 0
0 0 0 0 7 7 7 7 7 7 7 7 0 0 0 0 0
0 0 0 0 0 0 0 0 0 0 0 0 0 0 0 0 0
0 0 0 0 0 0 0 0 0 0 0 0 0 0 0 0 0
0 0 0 0 0 0 0 0 0 0 0 0 0 0 0 0 0
